NO ./img/bluestone.xpm

        C             10,100,200

                    SO ./img/colorstone.xpm
                F 250,200,100
 WE  ./img/eagle.xpm

EA   ./img/redbrick.xpm


 111111111
1E000000001
 1000000001
10001110001
10101 1111
 1 1






