NO ./img/bluestone.xpm

        C             10,100,200

                    SO ./img/colorstone.xpm
                F 250,200,100
 WE  ./img/eagle.xpm

EA   ./img/redbrick.xpm


 1111111111111111
1000000000000000011
 1000000002000200001
1000111000E00201111
10101 11100001111
 1 1    100001
         1111 





