NO ./img/bluestone.xpm

        C             10,100,200

                    SO ./img/colorstone.xpm
                F 250,200,100
 WE  ./img/eagle.xpm

EA   ./img/redbrick.xpm


 1111111111111111
100000000200200021
 1000000200000020001
1000111000000201111
10101 1110000111111
 1 1    10N001
         1111 





