NO ./img/bluestone.xpm

        C             10,100,200

                    SO ./img/colorstone.xpm
                F 250,200,100
 WE  ./img/eagle.xpm

EA   ./img/redbrick.xpm


 1111111111111111
1E0000000000000001
 1000000001111111
10001110001
10101 1111
 1 1






