NO ./img/bluestone.xpm

        C             10,100,200

                    SO ./img/colorstone.xpm
                F 250,200,100
 WE  ./img/eagle.xpm

EA   ./img/redbrick.xpm


111111111111111111111111111
100100000000000000000000001
100N00000000000000000000001 
111111111111111111111111111






